小重山·春到长门春草青 - 李清照
酬乐天咏老见示 - 刘禹锡
鹊桥仙·纤云弄巧 - 秦观
不第后赋菊 - 黄巢
雪梅 - 卢钺
己亥杂诗 - 龚自珍
乞巧 - 林杰
于易水送人 - 骆宾王
山亭夏日 - 高骈
渔家傲·天接云涛连晓雾 - 李清照
扬州慢·淮左名都 - 姜夔
咏二十四气诗·夏至五月中 - 元稹
石灰吟 - 于谦
乡村四月 - 翁卷
塞下曲 - 卢纶
长歌行 - 汉乐府
望月怀远 - 张九龄
清平乐·春归何处 - 黄庭坚
敕勒歌 - 乐府诗集
浣溪沙·一曲新词酒一杯 - 晏殊
村晚 - 雷震
卜算子·送鲍浩然之浙东 - 王观
苏幕遮·燎沉香 - 周邦彦
山坡羊·潼关怀古 - 张养浩
迢迢牵牛星 - 佚名
元宵 - 唐寅
垓下歌 - 项羽
游园不值 - 叶绍翁
题李凝幽居 - 贾岛
春日 - 朱熹
观书有感·其一 - 朱熹
四时田园杂兴·其三十一 - 范成大
赋得江边柳 - 鱼玄机
子衿 - 诗经·国风·郑风
关雎 - 诗经·国风·周南
蒹葭 - 诗经·国风·秦风
采苓 - 诗经·国风·唐风
短歌行 - 曹操
观沧海 - 曹操
菩萨蛮·小山重叠金明灭 - 温庭筠
己酉端午 - 贝琼
滕王阁序 - 王勃
商山早行 - 温庭筠
菊花 - 元稹
闻乐天授江州司马 - 元稹
咏廿四气诗·芒种五月节 - 元稹
马说 - 韩愈
宿新市徐公店二首其一 - 杨万里
小石潭记 - 柳宗元
送柴侍御 - 王昌龄
